_______________________________
______________________________
_[______________^_____________]
##______________#_#________####
________________*______#_______
________________#_##___________
_______________________________
^^^^^^^^^^^^^^^^^^^^^^^^^^^^^^^