#*__________#___]
#___________#___#
#____#____#_#___#
#____#____#_#___#
#___###___#_#___#
##[______##_____#