__________________#
________________]_#
#*______________#_#
#___________#_____#
#____#______#_____#
#____#____#_#___#_#
#____##___#_##__#_#
##[^_____##____##^#