__________##_______
___________##______
____________#______
__________________#
______##__####___##
__^__###^^####^^^##