___________##
____________#
_____________
_______##__##
__^^__###^^##