__^_^_^_^_^_^_
_[#_#_#_#_#*#_
_######_###___
_######_##__#_
_######_###___
_#__________#_
_#_##########_
_#____________
_##_______#___
^#^^^^^]^^^^#^