^____________
#___________*
#______#_____
##___________
###_[_^^^^_]_