####################################
#_____________________________######
#[_____________________________#####
#####^##^##^___#_#______________####
#############__#_#######^________###
#___________________#####__#______##
#]_______#________________________*#
##^#^#^^##^#^^^#^^^^^^^^^^^^^^^^^###
####################################