_______________________________
______________________________
_[______________^_____________]
##______________#_#________####
_______________________#_______
________________#_##___________
_______________________________
^^^^^^^^^^^^^^^^^^^^^^^^^^^^^^^