__*____________________________
__#____#_______________________
__________##___________________
___________##_________>________
____________#_____________^____
_______>__________##_____###___
__!___##__####___###_____####__
[_^__###^^####^^^###^^^^^#####]