__*____________________________
__#____#_______________________
__________##___________________
___________##__________________
____________#_____________^____
__________________##_____###___
______##__####___###_____####__
[_^__###^^####^^^###^^^^^#####]