__*____________________________
__#____#_______________________
__________##___________________
___________##__________________
____________#_____________^____
______i___________##_____###___
______##__####___###_____####__
[_^__###^^####^^^###^^^^^#####]