__#____#_______________________
__________##___________________
___________##_____________^____
____________#_____________#____
__________________##_____###___
______##__####___###_____####__
[_^__###^^####^^^###^^^^^#####]