_________________
_________________
_[_______________
##______________#
_________________
________________*
_________________
^]^^^^^^^^^^^^^^^