_________________
_________________
_[_______________
###_____________#
_________________
________________*
_________________
^]^^^_^^^^^^^^^^^