_________________
_________________
_[_______________
###_____________#
_________________
^_______________*
#________________
#]^^^_^^^^^^^^^^^