___^________________
___#________________
__#___*__^__________
#_____#__#_________]
__#______#___#_____#
#______[____##^^^^^#