##_________________#
##________________]#
##________________##
##_____________#__##
##________________##
##[________#___*__##
####_^^^^^^^^^^#^^##
####################