####################################
#_____________________________######
#[_____________________________#####
#####^##^##^___#_#______________####
#############__#_#######^________###
#___________________#####_#_______##
#]_______#_________________________#
##^#^#^^##^#^^^#^^^^^^^^^^^^^^^^^###
####################################