####################################
#[____________________________######
#####^##^##^___#_#______________####
#############__#_#######^_________##
#___________________#####_#________#
#]_____#^##________________________#
^^^#^#^^###^^^^^^^^^^^^^^^^^^^^^^###
####################################