##_________________#
##________________]#
##________________##
##_____________#__##
##________________##
##[________#______##
####_^^^^^^^^^^#^^##
####################
####################