__^_^__________________^__
__#*#__#_______#____#__#__
__###______#______________
___#____#______________^_^
[_____#^^^^^^^^^^^^^^^^#]#