#___#_____
#_[_#_____
#_#_#_____
#___#_____
#___#_____
#___#_____
#_________
#________]
#^*^#^^^^#