#____#_______
#___[#_______
#____#_______
#____#_______
#____#_______
#_^^_#_______
#_####_______
#____#_______
#____#_______
####_#_______
#____#_______
#________^__*
#]_^_#___#___