_____*___#________
_____#____________
_____#____________
__________________
^^^#_[_#^^^^^^^^^]