______________
__________*___
_____#________
_____#________
^^^#_[_#^^^^^]