_____*___#________
_____#____________
_____#____________
_____#____________
^^^#_[_#^^^^^^^^^]